13
2 0 128 128 8 2
11 3 3 0 3 3 3 2 3 3 0 3
25 0 128 128 8 2
11 3 3 0 3 3 3 2 3 3 0 3
25 5 128 128 8 2
21 0 2 0 2 0 2 0 2 0 2 3 3 0 3 3 3 2 3 3 0 3
70 0 128 128 8 2
11 3 3 0 3 3 3 2 3 3 0 3
73 3 128 128 8 2
11 3 3 0 3 3 3 2 3 3 0 3
76 3 128 128 8 2
11 3 3 0 3 3 3 2 3 3 0 3
79 3 128 128 8 2
11 3 3 0 3 3 3 2 3 3 0 3
95 1 128 128 8 2
9 3 3 3 3 3 3 3 0 3
100 4 128 128 8 2
9 3 3 3 3 3 3 3 0 3
101 4 128 128 8 2
9 3 3 3 3 3 3 3 0 3
115 2 128 128 8 2
11 3 3 0 3 3 3 2 3 3 0 3
116 2 128 128 8 2
11 3 3 0 3 3 3 2 3 3 0 3
117 2 128 128 8 2
11 3 3 0 3 3 3 2 3 3 0 3
