5
9 5 128 128
0 2 2 2 2 2 2 2 0
3 1 2 1 1 1 1 1 0
0 1 1 1 2 1 1 1 4
0 2 2 2 2 2 2 2 0
0 0 0 0 0 0 0 0 0

0 2 2 2 2 2 2 2 0
3 1 2 1 1 1 1 1 0
0 1 1 1 2 1 1 1 4
0 2 2 2 2 2 2 2 0
0 0 0 0 0 0 0 0 0
